VICII/banking/banking.prg	PAL	screenshot
VICII/border/border-250.prg	PAL	screenshot
VICII/border/border-251.prg	PAL	screenshot
VICII/border/border-252.prg	PAL	screenshot
VICII/border/border-bm-idle.prg	PAL	screenshot
VICII/border/border-bm-ysh2.prg	PAL	screenshot
VICII/border/border-bm-ysh.prg	PAL	screenshot
VICII/border/border-mcbm.prg	PAL	screenshot
VICII/border/hvborder1.prg	PAL	screenshot
VICII/border/hvborder2.prg	PAL	screenshot
VICII/border/vborder.prg	PAL	interactive
VICII/border/vborder-32-08.prg	PAL	screenshot
VICII/border/vborder-32-09.prg	PAL	screenshot
VICII/border/vborder-33-08.prg	PAL	screenshot
VICII/border/vborder-33-09.prg	PAL	screenshot
VICII/border/vborder2.prg	PAL	interactive
VICII/border/vborder2-21.prg	PAL	screenshot
VICII/border/vborder2-22.prg	PAL	screenshot
VICII/border/vborder2-35.prg	PAL	screenshot
VICII/border/vborder2-36.prg	PAL	screenshot
VICII/border/vborder2-63.prg	PAL	screenshot
VICII/border/vborder2-64.prg	PAL	screenshot
VICII/border/vborder_ntsc.prg	NTSC	interactive
VICII/border/vborder2_ntsc.prg	NTSC	interactive
VICII/border/vborder_ntscold.prg	NTSCOLD	interactive
VICII/border/vborder2_ntscold.prg	NTSCOLD	interactive
VICII/colorram/test.prg	?	?
VICII/colorsplit/colorsplit.prg	PAL	screenshot
VICII/D011Test/d011h1.prg	PAL	interactive
VICII/D011Test/d011h2.prg	PAL	interactive
VICII/D011Test/d011n.prg	PAL	interactive
VICII/D011Test/d011ntsc.prg	NTSC	interactive
VICII/D011Test/d011sc.prg	PAL	interactive
VICII/D011Test/d011v1.prg	PAL	interactive
VICII/D011Test/d011v2.prg	PAL	interactive
VICII/D011Test/d011ver.prg	PAL	interactive
VICII/D011Test/d011vt.prg	PAL	interactive
VICII/D011Test/hh3.prg	PAL	interactive
VICII/D011Test/hh.prg	PAL	interactive
VICII/D011Test/s1.prg	PAL	interactive
VICII/D011Test/vicnt2.prg	PAL	interactive
VICII/D011Test/disable-bad.prg	PAL	screenshot
VICII/D011Test/disable-bad_ntsc.prg	NTSC	screenshot
VICII/D011Test/disable-bad_ntscold.prg	NTSCOLD	screenshot
VICII/dentest/den01-48-0.prg	PAL	screenshot
VICII/dentest/den01-48-1.prg	PAL	screenshot
VICII/dentest/den01-48-2.prg	PAL	screenshot
VICII/dentest/den01-49-0.prg	PAL	screenshot
VICII/dentest/den01-49-1.prg	PAL	screenshot
VICII/dentest/den01-49-2.prg	PAL	screenshot
VICII/dentest/den10-48-0.prg	PAL	screenshot
VICII/dentest/den10-48-1.prg	PAL	screenshot
VICII/dentest/den10-48-2.prg	PAL	screenshot
VICII/dentest/den10-51-0.prg	PAL	screenshot
VICII/dentest/den10-51-1.prg	PAL	screenshot
VICII/dentest/den10-51-2.prg	PAL	screenshot
VICII/dentest/den10-51-3.prg	PAL	screenshot
VICII/dentest/denrsel-0.prg	PAL	screenshot
VICII/dentest/denrsel-1.prg	PAL	screenshot
VICII/dentest/denrsel-2.prg	PAL	screenshot
VICII/dentest/denrsel55.prg	PAL	screenshot
VICII/dentest/denrsel-63.prg	PAL	screenshot
VICII/dentest/denrsel-s0.prg	PAL	screenshot
VICII/dentest/denrsel-s1.prg	PAL	screenshot
VICII/dentest/denrsel-s2.prg	PAL	screenshot
VICII/dentest/den01-48-0_ntsc.prg	NTSC	screenshot
VICII/dentest/den01-48-1_ntsc.prg	NTSC	screenshot
VICII/dentest/den01-48-2_ntsc.prg	NTSC	screenshot
VICII/dentest/den01-49-0_ntsc.prg	NTSC	screenshot
VICII/dentest/den01-49-1_ntsc.prg	NTSC	screenshot
VICII/dentest/den01-49-2_ntsc.prg	NTSC	screenshot
VICII/dentest/den10-48-0_ntsc.prg	NTSC	screenshot
VICII/dentest/den10-48-1_ntsc.prg	NTSC	screenshot
VICII/dentest/den10-48-2_ntsc.prg	NTSC	screenshot
VICII/dentest/den10-51-0_ntsc.prg	NTSC	screenshot
VICII/dentest/den10-51-1_ntsc.prg	NTSC	screenshot
VICII/dentest/den10-51-2_ntsc.prg	NTSC	screenshot
VICII/dentest/den10-51-3_ntsc.prg	NTSC	screenshot
VICII/dentest/denrsel-0_ntsc.prg	NTSC	screenshot
VICII/dentest/denrsel-1_ntsc.prg	NTSC	screenshot
VICII/dentest/denrsel-2_ntsc.prg	NTSC	screenshot
VICII/dentest/denrsel-63_ntsc.prg	NTSC	screenshot
VICII/dentest/denrsel-s0_ntsc.prg	NTSC	screenshot
VICII/dentest/denrsel-s1_ntsc.prg	NTSC	screenshot
VICII/dentest/denrsel-s2_ntsc.prg	NTSC	screenshot
VICII/dentest/denrsel55_ntsc.prg	NTSC	screenshot
VICII/dentest/den01-48-0_ntscold.prg	NTSCOLD	screenshot
VICII/dentest/den01-48-1_ntscold.prg	NTSCOLD	screenshot
VICII/dentest/den01-48-2_ntscold.prg	NTSCOLD	screenshot
VICII/dentest/den01-49-0_ntscold.prg	NTSCOLD	screenshot
VICII/dentest/den01-49-1_ntscold.prg	NTSCOLD	screenshot
VICII/dentest/den01-49-2_ntscold.prg	NTSCOLD	screenshot
VICII/dentest/den10-48-0_ntscold.prg	NTSCOLD	screenshot
VICII/dentest/den10-48-1_ntscold.prg	NTSCOLD	screenshot
VICII/dentest/den10-48-2_ntscold.prg	NTSCOLD	screenshot
VICII/dentest/den10-51-0_ntscold.prg	NTSCOLD	screenshot
VICII/dentest/den10-51-1_ntscold.prg	NTSCOLD	screenshot
VICII/dentest/den10-51-2_ntscold.prg	NTSCOLD	screenshot
VICII/dentest/den10-51-3_ntscold.prg	NTSCOLD	screenshot
VICII/dentest/denrsel-0_ntscold.prg	NTSCOLD	screenshot
VICII/dentest/denrsel-1_ntscold.prg	NTSCOLD	screenshot
VICII/dentest/denrsel-2_ntscold.prg	NTSCOLD	screenshot
VICII/dentest/denrsel-63_ntscold.prg	NTSCOLD	screenshot
VICII/dentest/denrsel-s0_ntscold.prg	NTSCOLD	screenshot
VICII/dentest/denrsel-s1_ntscold.prg	NTSCOLD	screenshot
VICII/dentest/denrsel-s2_ntscold.prg	NTSCOLD	screenshot
VICII/dentest/denrsel55_ntscold.prg	NTSCOLD	screenshot
VICII/dmadelay/test1.prg	PAL	interactive
VICII/dmadelay/test1-2a-03.prg	PAL	screenshot
VICII/dmadelay/test1-2a-04.prg	PAL	screenshot
VICII/dmadelay/test1-2a-10.prg	PAL	screenshot
VICII/dmadelay/test1-2a-11.prg	PAL	screenshot
VICII/dmadelay/test1-2a-16.prg	PAL	screenshot
VICII/dmadelay/test1-2a-17.prg	PAL	screenshot
VICII/dmadelay/test1-2a-18.prg	PAL	screenshot
VICII/dmadelay/test2.prg	PAL	interactive
VICII/dmadelay/test2-28-05.prg	PAL	screenshot
VICII/dmadelay/test2-28-06.prg	PAL	screenshot
VICII/dmadelay/test2-28-11.prg	PAL	screenshot
VICII/dmadelay/test2-28-12.prg	PAL	screenshot
VICII/dmadelay/test2-28-16.prg	PAL	screenshot
VICII/dmadelay/test2-28-17.prg	PAL	screenshot
VICII/dmadelay/test2-28-18.prg	PAL	screenshot
VICII/dmadelay/test3.prg	PAL	interactive
VICII/dmadelay/test3-28-07.prg	PAL	screenshot
VICII/dmadelay/test3-28-08.prg	PAL	screenshot
VICII/dmadelay/test3-28-13.prg	PAL	screenshot
VICII/dmadelay/test3-28-14.prg	PAL	screenshot
VICII/dmadelay/test3-28-18.prg	PAL	screenshot
VICII/dmadelay/test3-28-19.prg	PAL	screenshot
VICII/dmadelay/test3-28-1a.prg	PAL	screenshot
VICII/dmadelay/test4.prg	PAL	interactive
VICII/fldscroll/fldscroll.prg	PAL	interactive
VICII/fldscroll/fldscroll-20-60.prg	PAL	screenshot
VICII/fldscroll/fldscroll-21-60.prg	PAL	screenshot
VICII/fldscroll/fldscroll-22-60.prg	PAL	screenshot
VICII/fldscroll/fldscroll-29-60.prg	PAL	screenshot
VICII/fldscroll/fldscroll-2A-60.prg	PAL	screenshot
VICII/fldscroll/fldscroll-2B-60.prg	PAL	screenshot
VICII/flibug/blackmail-ee.prg	PAL	screenshot
VICII/flibug/blackmail-fixed.prg	PAL	screenshot
VICII/frodotests/3fff.prg	PAL	interactive
VICII/frodotests/d011h3.prg	PAL	interactive
VICII/frodotests/fld.prg	PAL	interactive
VICII/frodotests/lrborder.prg	PAL	interactive
VICII/frodotests/sprsync.prg	PAL	interactive
VICII/frodotests/stretch.prg	PAL	interactive
VICII/frodotests/tech-tech.prg	PAL	interactive
VICII/frodotests/text26.prg	PAL	screenshot
VICII/gfxfetch/gfxfetch.prg	PAL	screenshot
VICII/gfxfetch/gfxfetch_ntsc.prg	NTSC	screenshot
VICII/gfxfetch/gfxfetch_ntscold.prg	NTSCOLD	screenshot
VICII/greydot/greydot.prg	PAL	screenshot
VICII/lpcoordinates/lpcoords.prg	?	interactive
VICII/lplatency/lplatency.prg	PAL	?
VICII/lp-trigger/test1.prg	PAL	screenshot
VICII/lp-trigger/test2.prg	PAL	?
VICII/lp-trigger/test2new.prg	PAL	?
VICII/movesplit/movesplit.prg	PAL	analyzer
VICII/movesplit/movesplit_ntsc.prg	NTSC	analyzer
VICII/movesplit/movesplit_ntscold.prg	NTSCOLD	analyzer
VICII/phi1timing/phi1timing.prg	PAL	?
VICII/phi1timing/phi1timing_ntsc.prg	NTSC	?
VICII/phi1timing/phi1timing_ntscold.prg	NTSCOLD	?
VICII/rasterirq/rasterirq_hold.prg	PAL	screenshot
VICII/screenpos/screenpos.prg	PAL	screenshot
VICII/sb_sprite_fetch/sbsprf24-163.prg	PAL	screenshot
VICII/sb_sprite_fetch/sbsprf24-164.prg	PAL	screenshot
VICII/screenpos/screenpos_ntsc.prg	NTSC	screenshot
VICII/screenpos/screenpos_ntscold.prg	NTSCOLD	screenshot
VICII/split-tests/bascan/bascan.prg	PAL	?
VICII/split-tests/fetchsplit/fetchsplit.prg	PAL	screenshot
VICII/split-tests/lightpen/lightpen.prg	?	?
VICII/split-tests/modesplit/modesplit.prg	?	screenshot
VICII/split-tests/spritescan/spritescan.prg	PAL	?
VICII/vicii_timing/vicii_reg_timing.prg	PAL	screenshot
VICII/vicii_timing/vicii_reg_timing-a5.prg	PAL	screenshot
VICII/vicii_timing/vicii_reg_timing-ff.prg	PAL	screenshot
VICII/videomode/rmwtest.prg	PAL	screenshot
VICII/videomode/rmwtest_ntsc.prg	NTSC	screenshot
VICII/videomode/rmwtest_ntscold.prg	NTSCOLD	screenshot
VICII/videomode/videomode1.prg	PAL	screenshot
VICII/videomode/videomode2.prg	PAL	screenshot
VICII/videomode/videomode-v.prg	PAL	screenshot
VICII/videomode/videomode-w.prg	PAL	screenshot
VICII/videomode/videomode-x.prg	PAL	screenshot
VICII/videomode/videomode-y.prg	PAL	screenshot
VICII/videomode/videomode-z.prg	PAL	screenshot
VICII/videomode/videomode-v_ntsc.prg	NTSC	screenshot
VICII/videomode/videomode-w_ntsc.prg	NTSC	screenshot
VICII/videomode/videomode-x_ntsc.prg	NTSC	screenshot
VICII/videomode/videomode-y_ntsc.prg	NTSC	screenshot
VICII/videomode/videomode-z_ntsc.prg	NTSC	screenshot
VICII/videomode/videomode2_ntsc.prg	NTSC	screenshot
VICII/videomode/videomode1_ntsc.prg	NTSC	screenshot
VICII/videomode/videomode1_ntscold.prg	NTSCOLD	screenshot
VICII/videomode/videomode2_ntscold.prg	NTSCOLD	screenshot
VICII/videomode/videomode-v_ntscold.prg	NTSCOLD	screenshot
VICII/videomode/videomode-w_ntscold.prg	NTSCOLD	screenshot
VICII/videomode/videomode-x_ntscold.prg	NTSCOLD	screenshot
VICII/videomode/videomode-y_ntscold.prg	NTSCOLD	screenshot
VICII/videomode/videomode-z_ntscold.prg	NTSCOLD	screenshot
VICII/vspbug/lft-safe-vsp.prg	PAL	interactive
VICII/vspbug/vsp_bug.prg	?	?
VICII/sequencer-bug/bug.prg	PAL	screenshot
VICII/sprite0move/sprite0move.prg	PAL	analyzer
VICII/spritebug/spritebug.prg	PAL	interactive
VICII/spritebug/spritebug-104.prg	PAL	screenshot
VICII/spritebug/spritebug-105.prg	PAL	screenshot
VICII/spritebug/spritebug-106.prg	PAL	screenshot
VICII/spritecollisions/sprite-gfx-collision-cycle.prg	PAL	?
VICII/spritecollisions/sprite-sprite-collision-cycle.prg	PAL	?
VICII/spritecollisions/sprite-sprite.prg	PAL	?
VICII/spritecrunch/spritecrunch.prg	PAL	interactive
VICII/spritecrunch/spritecrunch-3b-00.prg	PAL	screenshot
VICII/spritecrunch/spritecrunch-3c-00.prg	PAL	screenshot
VICII/spritecrunch/spritecrunch-3d-00.prg	PAL	screenshot
VICII/spritecrunch/spritecrunch2.prg	PAL	interactive
VICII/spritecrunch/spritecrunch2-07.prg	PAL	screenshot
VICII/spritecrunch/spritecrunch2-08.prg	PAL	screenshot
VICII/spritecrunch/spritecrunch2-09.prg	PAL	screenshot
VICII/spritecrunch/spritecrunch2-25.prg	PAL	screenshot
VICII/spritecrunch/spritecrunch2-26.prg	PAL	screenshot
VICII/spritecrunch/spritecrunch2-27.prg	PAL	screenshot
VICII/spritecrunch/spritecrunch2-28.prg	PAL	screenshot
VICII/spritecrunch/spritecrunch2-29.prg	PAL	screenshot
VICII/spritedma/d017-54.prg	PAL	screenshot
VICII/spritedma/d017-57.prg	PAL	screenshot
VICII/spritedma/d017-54_ntsc.prg	NTSC	screenshot
VICII/spritedma/d017-57_ntsc.prg	NTSC	screenshot
VICII/spritedma/d017-54_ntscold.prg	NTSCOLD	screenshot
VICII/spritedma/d017-57_ntscold.prg	NTSCOLD	screenshot
VICII/spriteenable/spriteenable1.prg	PAL	screenshot
VICII/spriteenable/spriteenable2.prg	PAL	screenshot
VICII/spriteenable/spriteenable3.prg	PAL	screenshot
VICII/spriteenable/spriteenable4.prg	PAL	screenshot
VICII/spriteenable/spriteenable5.prg	PAL	screenshot
VICII/spriteenable/spriteenable1_ntsc.prg	NTSC	screenshot
VICII/spriteenable/spriteenable2_ntsc.prg	NTSC	screenshot
VICII/spriteenable/spriteenable3_ntsc.prg	NTSC	screenshot
VICII/spriteenable/spriteenable4_ntsc.prg	NTSC	screenshot
VICII/spriteenable/spriteenable5_ntsc.prg	NTSC	screenshot
VICII/spriteenable/spriteenable1_ntscold.prg	NTSCOLD	screenshot
VICII/spriteenable/spriteenable2_ntscold.prg	NTSCOLD	screenshot
VICII/spriteenable/spriteenable3_ntscold.prg	NTSCOLD	screenshot
VICII/spriteenable/spriteenable4_ntscold.prg	NTSCOLD	screenshot
VICII/spriteenable/spriteenable5_ntscold.prg	NTSCOLD	screenshot
VICII/spritefetchbug/test.prg	PAL	interactive
VICII/spritefetchbug/test-136-2a.prg	PAL	screenshot
VICII/spritegap/spritegap2.prg	?	?
VICII/spritegap/spritegap3.prg	?	?
VICII/spritemcbase/spritemcbase.prg	?	interactive
VICII/spritepriorities/test1.prg	?	screenshot
VICII/spriterestart/spriterestart.prg	PAL	?
VICII/spritesplit/ss-exp-unexp-hires.prg	PAL	screenshot
VICII/spritesplit/ss-exp-unexp-mc.prg	PAL	screenshot
VICII/spritesplit/ss-hires-color.prg	PAL	screenshot
VICII/spritesplit/ss-hires-mc-exp.prg	PAL	screenshot
VICII/spritesplit/ss-hires-mc.prg	PAL	screenshot
VICII/spritesplit/ss-mc-color0.prg	PAL	screenshot
VICII/spritesplit/ss-mc-color1.prg	PAL	screenshot
VICII/spritesplit/ss-mc-color2.prg	PAL	screenshot
VICII/spritesplit/ss-mc-hires-exp.prg	PAL	screenshot
VICII/spritesplit/ss-mc-hires.prg	PAL	screenshot
VICII/spritesplit/ss-pri-exp.prg	PAL	screenshot
VICII/spritesplit/ss-pri-mc-exp.prg	PAL	screenshot
VICII/spritesplit/ss-pri-mc.prg	PAL	screenshot
VICII/spritesplit/ss-pri.prg	PAL	screenshot
VICII/spritesplit/ss-unexp-exp-hires.prg	PAL	screenshot
VICII/spritesplit/ss-unexp-exp-mc.prg	PAL	screenshot
VICII/spritesplit/ss-xpos.prg	PAL	screenshot
VICII/spritesteal/spritesteal.prg	PAL	?
VICII/spritesteal/spritesteal_ntsc.prg	NTSC	?
VICII/spritesteal/spritesteal_ntscold.prg	NTSCOLD	?
VICII/spritevssprite/spritevssprite.prg	PAL	?
VICII/spritex/demusinterruptus.prg	PAL	?
VICII/spritex/testsuite.prg	PAL	?
VICII/spritex/testsuite_ntsc.prg	NTSC	?
VICII/spritex/testsuite_ntscold.prg	NTSCOLD	?
VICII/spritey/spritey.prg	PAL	?
snapshots/eod_grid.vsf	PAL	screenshot
snapshots/eod_hand.vsf	PAL	screenshot
snapshots/eod_squares.vsf	PAL	screenshot
snapshots/eod_terminator.vsf	PAL	screenshot
snapshots/krestage.vsf	PAL	screenshot
snapshots/krestage3.vsf	PAL	screenshot
snapshots/lunatico_misc.vsf	PAL	screenshot
snapshots/smb.vsf	PAL	screenshot
snapshots/snapshot.vsf	PAL	screenshot
snapshots/uncensored_dancefloor.vsf	PAL	screenshot
snapshots/uncensored_mirrors.vsf	PAL	screenshot
snapshots/uncensored_satellite.vsf	PAL	screenshot
snapshots/uncensored_skihill.vsf	PAL	screenshot
snapshots/uncensored_sprites.vsf	PAL	screenshot
snapshots/weare.vsf	PAL	screenshot
snapshots/xscroll2.vsf	PAL	screenshot
